母	母ちゃん/かあちゃん/お袋/おふくろ/御っ母/おっはは/御母/おはは/御っ母さん/おっかあさん/お母さん/おかあさん/お母/おっ母さん/母さん/かあさん/おっ母/ママ/マミー/母/はは/御母さん/ムッター/マザー/実母/じつぼ/母親/ははおや/お母様/おははさま/母君/ははぎみ/母御/ははお/母上/ははうえ/母様/ははさま/女親/おんなおや/母じゃ人/ははじゃにん/お母さま/おかあさま/かあ様/かあさま/母者人/ははものにん/垂乳女/すいちちおんな/慈母/じぼ/垂乳根/すいちちね/御母様
平日	週日/しゅうじつ/ウィークデー/ウィークデイ/ウイークデー/仕事日/しごとにち/月曜日/げつようび/火曜日/かようび/水曜日/すいようび/木曜日/もくようび/金曜日/きんようび
容器	灰皿/はいざら/巣箱/すばこ/ケース/コインボックス/ゴミ箱/ゴミはこ/ごみ箱/ごみはこ/ホッパー/湯湯婆/ゆゆばあ/湯たんぽ/ゆたんぽ/受信箱/じゅしんはこ/痰壷/たんつぼ/トレイ/盆/ぼん/御盆/おぼん/トレー/お盆
デザート	饅頭/まんじゅう/まんじゅう/抹茶アイス/まっちゃアイス/アイス/レアチーズケーキ/ミルフィーユ/ベイクドアラスカ/ブラマンジェ/チャルロット/コンポート/団子/だんご/パフェ/氷菓/こおりか/冷菓/れいか/氷菓子/こおりかし/フラン/ジャンケット/プリン/ティラミス/チョコケーキ
ギター	エレキ/アコースティックギター/エレクトリックベース/エレベ/エレキベース/シターン/電気ギター/でんきギター/エレキギター/スチールギター/ハワイアンギター/ウクレレ
首飾り	チョーカー/ペンダント/ネクレス
肉	牛肉/ぎゅうにく/牛/うし/ビーフ/鳥肉/とりにく/コールドカット/肉切れ/にくきれ/肉片/にくへん/鳥もも肉/とりももにく/エスカルゴ/ジビエ/野生肉/やせいにく/狩猟肉/しゅりょうにく/ハラール/桜肉/さくらにく/馬肉/ばにく/乾肉/いぬいにく/干し肉/ほしにく/ジャーキー/子ヒツジ/こヒツジ/小羊/しょうひつじ/ラム/仔羊/しひつじ/子羊/こひつじ/子羊肉/こひつじにく/ムートン/羊肉/ひつじにく/マトン/羊/ひつじ/ムトン/ペミカン/ポーク/豚/ぶた/豚肉/ぶたにく/生肉/なまにく/赤肉/あかにく/ソーセージ/フランクフルター/フランクフルトソーセージ/腸詰め/ちょうづめめ/腸詰/ちょうづめ/ソーセージ用肉/ソーセージようにく/煮込み用肉/にこみようにく/臓物/ぞうもつ/子牛/こうし
帽子	シャコー帽/シャコーぼう/麦藁帽/むぎわらぼう/麦わら/むぎわら/麦稈/むぎかん/麦藁/夏帽子/なつぼうし/麦稈帽子/むぎかんぼうし/パナマ帽/パナマぼう/かんかん帽/かんかんぼう/ストローハット/麦稈帽/むぎかんぼう/麦わら帽/麦藁帽子/むぎわらぼうし/ボンネット/ボネット/ポークボンネット/ボウラーハット/ダービー/ボウラー/山高/やまたか/ダービーハット/ボーラー/ボーラーハット/山高帽子/やまたかぼうこ/テンガロンハット/カウボーイハット/オペラハット/トップハット/シルクハット/中折れ帽/なかおれぼう/中折帽子/なかおりぼうし/フェルト帽 /フェルトぼう/ソフト帽/ソフトぼう/ソフト/中折/なかおり/中折帽/なかおりぼう/中折れ/なかおれ/フェドーラ/ ホンブルグ帽/ホンブルグぼう/中折れフェルト帽/なかおれフェルトぼう/中折れ帽子/なかおれぼうし/毛帽子/けぼうし/婦人帽/ふじんぼう/ソンブレロ/笠/かさ/トーク
窓	出窓/でまど/張出窓/ちょうでまど/クリアストーリー/ドーマーウインドー/ペアガラス/欄間/らんかん/バラ窓/バラまど/明り取り/あかりとり/スカイライト/明り窓/あかりまど/明りとり/明かり窓/天窓/てんまど/明採り/めいとり/明かり採り/明かりとり/明り採り/明取り/明かり取り/ステンドグラス窓/ステンドグラスまど/二重窓/にじゅうまど/欄間
週末	時間/じかん/期間/きかん/ピリオド/ピリオッド/期/き/時代/じだい/会期/かいき/年代/ねんだい/時期/じき/スパン
月	衛星/えいせい/サテライト
宝石	カボション/カット/玉瑛/たまえい
果物	梅/うめ/桃/もも/プラムリンゴ/林檎/りんご/りんご/アキー/アプリコット/杏/あんず/アンズ/アヴォカード/アボカド/アボカード/アヴォカド/バナナ/実/み/木の実/このみ/果実/かじつ/漿果/しょうか/木ノ実/きノみ/ベリー/液果/えきか/パンノキ/パンの木/パンのき/モンステラ/桜んぼう/さくらんぼう/桜ん坊/桜桃/おうとう/桜んぼ/さくらんぼ/サクランボ/サクランボウ/チェリー/カンキツ類/カンキツるい/蜜柑/みかん/柑橘類/かんきつるい/シトラス/くっつき/ポポー/乾果/かんか/棗椰子/なつめやし/ナツメヤシの果実/ナツメヤシのかじつ/デーツ/ドリアン/ニワトコ/いちじく/無花果状果/いちじくじょうか/無花果果/いちじくか/映日果/えいにちか/ウドンゲ/イチジク/無花果/優曇華/ゆうどんはな/グレープ/葡萄/ぶどう/ブドウ/グアバ/波羅蜜/なみらみつ/棗/なつめ/キウイ/キウイフルーツ/キーウィ/レイシ/ビワ/枇杷/びわ/マンゴー/マンゴスチン/メロン/瓜/うり/ネクタリン/パパイヤ/パッションフルーツ/ピーチ/モモ/セイヨウナシ/ナシ/ありの実/ありのみ/洋梨/ひろしなし/梨の実/なしのみ/梨/なし/ペア/ペヤ/西洋ナシ/せいようナシ/有の実/西洋梨/せいようなし/有りの実/パイナップル/李/すもも/酸桃/さんもも/ザクロ/ざくろ/マルメロ/ランブータン/サポジラ/タマリンド
鉄道	地下鉄/ちかてつ/メトロ/索条鉄道/さくじょうてつどう/ラック式鉄道/ラックしきてつどう/高架鉄道/こうかてつどう/高架線/こうかせん/サブウェー/地下鉄道/ちかてつみち/モノレール
電車	地下鉄/ちかてつ/カートレイン/貨物列車/かもつれっしゃ/旅客列車/りょきゃくれっしゃ/流線型列車/りゅうせんけいれっしゃ
魚	鮭/さけ/アンチョビー/うなぎ/ウナギ/ハドック/メルルーサ/ボラ/サケ/小鰭/しょうひれ/鱒/ます/マス
ツール	方法/ほうほう/すべ//遣り方/やりほう/方術/ほうじゅつ/仕方/しかた/手段/しゅだん/遣り口/やりくち/致し方/いたしかた/遣りくち/いたし方/いたしほう/由/ゆ/途方/とほう/遣口/けんくち/やり方/やり口仕様/やりくちしよう/致しかた
仕事	義務/ぎむ/労働/ろうどう/世話/せわ/時間つぶしの課題学習/じかんつぶしのかだいがくしゅう/時間つぶしの仕事/じかんつぶしのしごと/ケア/お守り/おまもり/めんどう/ケアー/援助/えんじょ/配慮/はいりょ/手当/てあて/面倒/厄介/やっかい/手当て/面倒を見ること/めんどうをみること/ご念/ごねん/教育用プログラム/きょういくようプログラム/勤め/つとめ/責め/せめ/務/つとむ/責任/せきにん/責務/せきむ/お役目/おやくめ/お役/おやく/努め/務め/御役/役/やく/役儀/やくぎ/役目/やくめ/ハウスキーピング/家政/かせい/家事/かじ/世帯/せたい/所帯/しょたい/調査/ちょうさ/アイロン掛け/アイロンかけ/肉体労働/にくたいろうどう/ 労役/ろうえき/残務/ざんむ/未処理事項/みしょりじこう/ミッション/伝道/でんどう/布教/ふきょう/布教活動/ふきょうかつどう/手続/てつづき/手続き/進め方/すすめかた/プロシジャ/順序/じゅんじょ/プロシージャ/手順/てじゅん/運び/はこび/やり方/やりほう/作業/さぎょう/書類事務/しょるいじむ/ペーパーワーク/文書業務/ぶんしょぎょうむ/書類仕事/しょるいしごと/サーヴィス/サービス/タイムワーク/課題/かだい/任務/にんむ/任/にん/タスク/務め/事業/じぎょう/プロジェクト/洗い物/あらいもの/洗い/あらい/水仕事/みずしごと/洗/せん/洗いもの/洗滌/せんじょう/水洗/すいせん/洗浄/洗物/せんもの/福祉事業/ふくしじぎょう
マグロ	キハダ/ビンナガ/黄肌/きはだ
飲み物	お酒/おさけ/コーヒー/御神酒/おみき/気違水/きいみず/気狂い水/きくるいみず/酒類/さけるい/アルコール飲料/アルコールいんりょう/気違い水/きちがいみず/酒/さけ/アルコホル/果実酒/かじつさけ/リンゴ酒/リンゴさけ/サイダー/ホットチョコレート/チョコ/チョコレート/ショコラ/チョコレート飲料/チョコレートいんりょう/ココア/カフェー/カフエ/フェ/珈琲/こーひー/キャフェ/飲み水/のみみず/お冷/おれい/飲料水/いんりょうすい/ お冷やし/おひやし/飲用水/いんようすい/御冷やし/飲水/いんみず/上水/かみみず/御冷/フィズ/エード/果汁/かじゅう/フルーツジュース/おっぱい/牛乳/ぎゅうにゅう/御乳/おちち/ミルク/市乳/しちち/乳汁/ちちしる/酪漿/らくしょう/乳/ちち/ミキサー/水薬/みずくすり/リフレッシャー/ジュース/清涼飲料/せいりょういんりょう/清涼飲料水/せいりょういんりょうすい/ソフトドリン/茶/ちゃ/お茶/おちゃ/ティー/紅茶/こうちゃ/御茶,/おちゃ,
食器	はし/瀬戸物/せともの/切れ物/きれもの/切物/せつもの/刃物/はもの/食器類/しょっきるい/皿/さら/ギヤマン/銀盤/ぎんばん/ティーセット
感情	エフェクト/体裁/ていさい/効果/こうか/洞察力/どうさつりょく/懐疑/かいぎ/嫌疑/けんぎ/感づくこと/かんづくこと/直覚/ちょっかく/直観/ちょっかん/直感/疑/ぎ/勘/かん/予感/よかん/予覚/あらかじめかく/疑い/うたがい/疑り/ぎり/疑念/ぎねん/疑心/ぎしん/疑惑/ぎわく/存在/そんざい/影/かげ
気温	血温/ちおん/体温/たいおん/絶対温度/ぜったいおんど/絶対零度/ぜったいれいど/沸点/ふってん/沸騰/ふっとう/冷/れい/凍/とう/寒さ/さむさ/寒気/さむけ/コールド/低温/ていおん/寒冷/かんれい/冷温 /れいおん/冷寒/れいかん/凍み/しみ/冷え/ひえ/冷え冷え/ひえひえ/冷ややかさ/ひややかさ/凛/りん/冷たい/つめたい/冷たさ/つめたさ/露点/つゆてん/引火点/いんかてん/氷点/ひょうてん/融解点/ゆうかいてん/大熱/だいねつ/温気/おんき/ヒート/熱/ねつ/火熱/かねつ/熱さ/あつさ/暑さ/熱気/ねっき/高温/こうおん/暑気/しょき/高熱/こうねつ/室温/しつおん
バーガー	チーズバーガー
子供	幼児/ようじ/赤ん坊/あかんぼう/赤ちゃん/あかちゃん/やや/ねんね/片子/へんこ/若児/じゃくじ/乳呑み子/ちちのみこ/ねね/ベビー/稚児/ちご/赤んぼう/赤児/あかじ/赤子/あかご/嬰児/えいじ/乳飲み子/乳児/にゅうじ/孩児/がいじ/みどり児/みどりじ/ベイビー緑児/ベイビーみどりじ/連っ子/れんっこ/連れっ児/つれっじ/連れっ子/つれっこ/連っ児/れんっじ/継子/ままこ/連れ子/つれこ
教会	聖堂/せいどう/大修道院/だいしゅうどういん/修道院/しゅうどういん/バジリカ/カセドラル/大聖堂/だいせいどう/伽藍/がらん/カテドラル/巨刹/きょさつ/ドゥオモ/カセドラル/大聖堂/カテドラル/ドゥオーモ/カーク
歌	頌歌/しょうか/アリア/譚歌/たんか/唄/うた/バラッド/バラード/ゴンドラの舟歌/ゴンドラのふなうた/挽歌/ばんか/レクイエム/葬送歌/そうそううた/葬送曲/そうそうきょく/葬歌/そううた/鎮魂曲/ちんこんきょく/鎮魂歌/ちんこんか/弔歌/ちょううた/誄歌/るいうた/民謡/みんよう/フォークソング/揺籃歌/ようらんうた/ララバイ/子守歌/こもりうた/ 子守唄/ベルスーズ/子守り歌/オールディー/スピリチュアル/セレナード/労働歌/ろうどううた/ワークソング
雲	コマ/エアゾール/エーロゾル/アエロゾル/煙霧質/けむりきりしつ/エアゾル/エアロゾル/宇宙塵/うちゅうじん/きのこ雲/きのこくも/茸雲/たけくも/星雲/せいうん
雨	大雨/おおあめ/モンスーン/土砂降り/どしゃぶり/豪雨/ごうう//どしゃ降り/どしゃおり/小雨/こさめ/細雨/さいあめ/粉糠雨/こなぬかあめ/糠雨/ぬかあめ/微雨/びあめ/小糠雨/しょうぬかあめ/霧雨/きりさめ/煙雨/けむりあめ/ぬか雨/季節風/きせつふう/土砂降り/暴風雨/ぼうふうう/白雨/はくう/肘雨/ひじあめ/俄雨/があめ/にわか雨/にわかあめ/俄か雨/夕立ち/ゆうだち/とおり雨/とおりあめ/急雨/きゅうあめ/通り雨/とうりあめ/肘笠雨/ひじかさあめ/通雨/夕立
雪	粗目/そめ/ざらめ雪/ざらめゆき/粗目雪/そめゆき/ザラメ雪/ザラメゆき/コーンスノー/べた雪/べたゆき/ベタ雪/ベタゆき
会社	商社/しょうしゃ/チェーン/チェイン/エイジェンシー/代理店/だいりてん/代理業/だいりぎょう/エージェンシー/荷担人/かたんにん/運送業者/うんそうぎょうもの/担い手/にないて/担ぎ/かつぎ/運送取扱い人/うんそうとりあつかいにん/荷持/かじ/運送人/うんそうにん/運輸業者/うんゆぎょうしゃ/運送取り扱い人/運送取扱人/一般運送業者/いっぱんうんそうぎょうもの/運搬人/うんぱんにん/荷持ち/かもち/公司/こうし/フランチャイズ/製造業者/せいぞうぎょうしゃ/製造会社/せいぞうがいしゃ/メーカ/メーカー/メイカー/製造者/せいぞうしゃ/製造元/せいぞうもと/パートナーシップ/合名会社/ごうめいがいしゃ/共同経営会社/きょうどうけいえいかいしゃ/農産物加工業者/のうさんぶつかこうぎょうしゃ/船大工/ふねだいく
靴下	足袋/たび/スポーツ靴下/スポーツくつした/スポーツソックス/アスレチックソックス/ボビーソックス/アンクレット/アーガイル靴下/アーガイルくつした/アーガイルソックス
メガネ	ゴーグル/黒眼鏡/くろめがね/サングラス
科目	専攻/せんこう/建築/けんちく/相対成長/そうたいせいちょう/アーキテクチャー/建築学/けんちくがく/アーキテクチュア/アーキテクチャ/神学/しんがく/神統記/しんとうき/人文科学/じんぶんかがく/人文/じんぶん/教養/きょうよう/数秘術/かずひじゅつ/科学の科目/かがくのかもく/科学/かがく/筆跡学/ひっせきがく/未来学/みらいがく/最前線/さいぜんせん/フロンティア/応用科学/おうようかがく/工学/こうがく/エンジニアリング/技法/ぎほう
お茶	紅茶/こうちゃ/紅茶の葉/こうちゃのは/紅茶葉/こうちゃは/緑茶/りょくちゃ/ウーロン茶/ウーロンちゃ/烏龍茶/うーろんちゃ/ティーバッグ
駅	終点/しゅうてん/始点/してん/中間駅/ちゅうかんえき
家	別荘/べっそう/ユルト/小屋宿/こややど/居/きょ/屋宇/やう/令堂/れいどう/室家/しついえ/棲家/せいいえ/ハウス/お家/おいえ/お宅/おたく/住屋/じゅうや/住居/じゅうきょ/住家/じゅうか/住宅/じゅうたく/家宅/かたく/家屋/かおく/家/いえ/館/かん/棲み家/すみいえ/戸/こ/住みか/すみか/住み処/すみところ/住み家/屋/や/宅/たく/建屋/たてや/メゾン/居館/きょかん/居宅/きょたく/居所/いどころ/人屋/にんや/人家/じんか/コンドミニアム
チョコレート	ミルクチョコレート/ホワイトチョコレート/ビターチョコ/ビターチョコレート/カカオバター
ホテル	宿/やど/中宿/なかじゅく/宿舎/しゅくしゃ/はたご屋/はたごや/布施屋/ふせや/御宿/おやど/ホステル/お宿/客亭/きゃくてい/逆旅/ぎゃくたび/客舎/きゃくしゃ/旅人宿/たびびとやど/旅荘/たびそう/旅館/りょかん/旅舎/たびしゃ/旅亭/たびてい/旅宿/たびやど/旅寓/たびぐう/旅店/たびみせ/ロッジ/リッツ/旅籠/たびかご/宿屋/やどや/旗亭/はたてい/人宿/にんやど/リゾートホテル/温泉/おんせん/イン モーターホテルリゾートホテル/インモーターホテルリゾートホテル
池	水たまり/みずたまり/つり堀/つりほり/水車用貯水池/すいしゃようちょすいち
カバン	ルックサック/リュック/バックパック/ナップサック/リュックサック/ザック/背嚢/はいのう/ロジンバッグ/ロージンバッグ/通学かばん/つうがくかばん/学校かばん/がっこうかばん/スクールバッグ/学校鞄/学生鞄/がくせいかばん/学校カバン/がっこうカバン/通学鞄/学生カバン/がくせいカバン/学生_カバン/がくせい_カバン/通学カバン/つうがくカバン/通学_カバン/つうがく_カバン/学生かばん/がくせいかばん/学生_かばん/がくせい_かばん/寝袋/ねぶくろ/革/かわ/買物袋/かいものぶくろ/ショッピングバッグ/買物袋/レジ袋/レジふくろ/匂い袋/においふくろ/ティーバッグ/ルックザック/リックサック/サブリュック/ナップザック/お手玉/おてだま/浮き袋/うきふくろ/氷袋/こおりふくろ/氷枕/こおりまくら/氷嚢/こおりのう/氷まくら/氷のう/金入れ/きんいれ/蟇口/ひきくち/銭入れ/せんいれ/金入/きんにゅう/蝦蟇口/がまくち/パース/財嚢/ざいのう/財布/さいふ/銭入/せんにゅう/がま口/郵袋/ゆうたい/ビニール袋/ビニールふくろ/巾着/きんちゃく/ポウチ/合財袋/がっさいふくろ/手提/ててい/合切袋/パウチ/ポーチ/ゴルフバッグ/南京袋/なんきんふくろ/封筒/ふうとう/上包み/うえつつみ/エンベロープ/遺体袋/いたいふくろ/笈/きゅう/トートバッグ/エアバッグ
みかん	ダイダイ/橙/だいだい
桃	核果/かくか/果物/くだもの
旅行	旅/たび/新婚旅行/しんこんりょこう/新婚_旅行/しんこん_りょこう/卒業＿旅行/そつぎょう＿りょこう
色	彩色/さいしょく/呈色/ていしょく/有彩色/ありさいしょく/無彩色/むさいしょく/色つや/しょくつや/膚色/はだしょく/面色/めんしょく/色艶/色差/しょくさ/肌色/はだいろ/色ざし/しょくざし/血色/けっしょく/顔色/かおいろ/ディザーカラー/原色色調/げんしょくしきちょう/色相/しきそう/色差し/しょくさし/色彩/しきさい/色合/いろあい/色ざし/色合い/ニュアンス/トーン
ベッド	寝台/しんだい/バース/ダブルベッド/ハンモック/床入/とこにゅう/シングルベッド/病床/びょうしょう/ツインベッド
詩	短歌/たんか/物語詩/ものがたりし/譚歌/バラッド/バラード/無韻詩/むいんし/哀歌/あいか/哀詩/あいし/弔歌/ちょううた/譚歌/エピック/叙事詩/じょじし/自由詩/じゆうし/俳句/はいく/十七文字/じゅうしちもじ/発句/はつく/句/く/叙情詩/じょじょうし/抒情詩/ソネット/詩/し/バース/詩歌/しいか/詩句/しく/韻文/いんぶん/篇什/へんしる
電話	内線/ないせん/無線/むせん/卓上電話/たくじょうでんわ/親子電話/おやこでんわ/ホームテレフォン/切替え電話/きりかえでんわ/ホームテレホン/スピーカーホン
バス	トロリーバス/ミニバス/スクールバス
耳	受容器/じゅようき/受容体/じゅようたい/感覚受容器/かんかくじゅようき/レセプター/レセプタ/感覚器/かんかくき/感官/かんかん/感覚器官/かんかくきかん