アリストテレス	ギリシャ人/ギリシャにん
バルザック	フランス人/フランスにん
ベートーベン	ドイツ人/ドイツにん
シーザー	ローマ人/ローマにん
ショパン	ポーランド人/ポーランドにん
ダーウィン	イギリス人/イギリスにん/英国人/えいこくじん
デカルト	フランス人/フランスにん
コロンブス	イタリア人/イタリアにん/英国人/えいこくじん
孔子	中国人/ちゅうごくじん
ホームズ	イギリス人/イギリスにん/英国人/えいこくじん
ドストエフスキー	ロシア人/ロシアにん
ヘミングウェイ	アメリカ人/アメリカにん/米国人/べいこくじん
アインシュタイン	ユダヤ人/ユダヤにん/ドイツ人/ドイツにん/アメリカ人/アメリカにん
三島	日本人/にほんじん
ゴルバチョフ	ロシア人/ロシアにん/ソ連人/ソれんにん/ソビエト人/ソビエトにん
モーツァルト	オーストリア人/オーストリアにん
ホーキング	イギリス人/イギリスにん/英国人/えいこくじん
ヘーゲル	ドイツ人/ドイツにん
ヒトラー	ドイツ人/ドイツにん/オーストリア人/オーストリアにん
ホーマー	ギリシャ人/ギリシャにん
ヒューム	イギリス人/イギリスにん/英国人/えいこくじん/スコットランド人/スコットランドにん
佐藤	日本人/にほんじん
カント	ドイツ人/ドイツにん
ケプラー	ドイツ人/ドイツにん
ライプニッツ	ドイツ人/ドイツにん
レノン	イギリス人/イギリスにん/英国人/えいこくじん
リンカーン	アメリカ人/アメリカにん/米国人/べいこくじん
ロック	イギリス人/イギリスにん/英国人/えいこくじん
マルクス	ドイツ人/ドイツにん
孟子	中国人/ちゅうごくじん
ミケランジェロ	イタリア人/イタリアにん
モーツァルト	ドイツ人/ドイツにん/オーストリア人/オーストリアにん
ナポレオン	フランス人/フランスにん/コルシカ人/コルシカにん/イタリア人/イタリアにん
ニュートン	イギリス人/イギリスにん/英国人/えいこくじん
パスカル	フランス人/フランスにん
プラトン	ギリシャ人/ギリシャにん
ポワロ	ベルギー人/ベルギーにん
ラファエル	イタリア人/イタリアにん
シェイクスピア	イギリス人/イギリスにん/英国人/えいこくじん
モーゼ	イスラエル人/イスラエルにん
スピノザ	オランダ人/オランダにん
スターリン	ソビエト人/ソビエトにん/グルジア人/グルジアにん
ストラウス	オーストリア人/オーストリアにん
ブッシュ	アメリカ人/アメリカにん/米国人/べいこくじん
ピカソ	スペイン人/スペインにん
シューベルト	オーストリア人/オーストリアにん
デュシャン	アメリカ人/アメリカにん/米国人/べいこくじん/フランス人/フランスにん
ワーグナー	ドイツ人/ドイツにん
ノストラダムス	フランス人/フランスにん
クリントン	アメリカ人/アメリカにん/米国人/べいこくじん