ギター	弾く/ひく
歯	磨く/みがく
箸	掴む/つかむ/つかむ/食べる/たべる
服	着る/きる
新聞	読む/よむ
雑誌	読む/よむ
飛行機	乗る/のる/搭乗/とうじょう
テレビ	見る/みる
パソコン	やる/利用/りよう/使う/つかう
文句	言う/いう
株	買う/かう/購入/こうにゅう/売る/うる
着物	着る/きる
外国語	習う/ならう/勉強/べんきょう/教える/おしえる/話す/はなす
経費	押さえる/おさえる/絞る/しぼる/削減/さくげん
タクシー	利用/りよう/乗車/じょうしゃ/呼ぶ/よぶ/乗車
疑い	持つ/もつ/抱く/だく/晴らす/はらす
借金	背負う/せおう/払う/はらう/返済/へんさい/する
食品	食べる/たべる/買う/かう
ナイフ	切る/きる
猫	飼う/かう
野球	やる/する/見る/みる/観る
ピアノ	弾く/ひく
ラジオ	聴く/きく/聞く
スープ	飲む/のむ/注ぐ/そそぐ/摂る/とる
シャツ	脱ぐ/ぬぐ/着用/ちゃくよう/着る/きる
薬	飲む/のむ/摂る/とる
夏休み	取る/とる/利用/りよう/過ごす/すごす
トランペット	吹く/ふく
スカート	履く/はく
靴	履く/はく
ネクタイ	しめる/する
予約	入れる/いれる/する/受ける/うける
栄養	摂る/とる
演奏	行う/おこなう/披露/ひろう/楽しむ/たのしむ/する/聞く/きく
コート	着る/きる
寿司	握る/にぎる/食べる/たべる
お湯	沸かす/わかす
食事	する
お風呂	入る/いる
シャワー	浴びる/あびる
太陽	浴びる/あびる
休憩	とる/取る
結婚	する
子供	生む/うむ/育てる/そだてる
離婚	する
契約	結ぶ/むすぶ/解約/かいやく/解約
バス	乗る/のる/降りる/おりる
メガネ	掛ける/かける/かける
帽子	かぶる
ドレス	脱ぐ/ぬぐ/着用/ちゃくよう/着る/きる